VVVVVVVVVVVVVVVVVV
VOOOZZZZZZZZVVVVVV
VOOOZZZZZZZZVVVVVV
VOOOZZZZZZZZVVVVVV
VOOOZZZZZZZZVVVVVV
VOOOZZZZZZZZVVVVVV
VOOOZZZZVZZZVVVVVV
VOOOZZZZVZZZVVVVVV
VVVVVVVVVZZZVVVVVV
OOOOOOOOOOOOVVVVVV
OOOOOOOOOOOOVVVVVV
OOOOOOOOOOOOVVVVVV
OOOOOOOOOOOOVVVVVV
OOOOOOOOOOOOVVVVVV
OOOOOOOOOOOOVVVVVV
OOOOOOOOOOOOVVVVVV
OOOOOOOOOOOOVVVVVV
OOOOOOOOOOOOVVVVVV
OOOOOOOOOOOOVVVVVV
OOOOOOOOOOOOVVVVVV
OOOOOOOOOOOOVVVVVV
OOOOOOOOOOOOVVVVVV
OOOOOOOOOOOOVVVVVV
OOOOOOOOOOOOVVVVVV
OOOOOOOOOOOOVVVVVV
OOOOOOOOOOOOVVVVVV
OOOOOOOOOOOOVVVVVV
OOOOOOOOOOOOVVVVVV
OOOOOOOOOOOOVVVVVV
OOOOOOOOOOOOVVVVVV
OOOOOOOOOOOOVVVVVV
VVVVVVVVVZZZVVVVVV
VOOOZZZZVZZZVVVVVV
VOOOZZZZVZZZVVVVVV
VOOOZZZZZZZZVVVVVV
VOOOZZZZZZZZVVVVVV
VOOOZZZZZZZZVVVVVV
VOOOZZZZZZZZVVVVVV
VOOOZZZZZZZZVVVVVV
VVVVVVVVVVVVVVVVVV
