VVVVVVVVVVVVVVVVVVVV
VVVVVVVVVVVVVVVVVVVV
VVVVVVVVVVVVVVVVVVVV
VVVVVVVVVVVVVVVVVVVV
VVVVVVVVVVVVVVVVVVVV
VVVVVVVVVVVVVVVVVVVV
VVVVVVVVVVVVVVVVVVVV
VVVVVVVVVVVVVVVVVVVV
VVVVVVVVVVVVVVVVVVVV
VVVVVVVVVVVVVVVVVVVV
VVVVVVVVVVVVVVVVVVVV
VVVVVVVVVVVVVVVVVVVV
VVVVVVVVVVVVVVVVVVVV
VVVVVVVVVVVVVVVVVVVV
VOOOZZZZZZZZVVVVVVVV
VOOOZZZZZZZZVVVVVVVV
VOOOZZZZZZZZVVVVVVVV
VOOOZZZZZZZZVVVVVVVV
VOOOZZZZZZZZVVVVVVVV
VOOOZZZZVZZZVVVVVVVV
VOOOZZZZVZZZVVVVVVVV
VVVVVVVVVZZZVVVVVVVV
POOOOOOOOOOOVVVVVVVV
POOOOOOOOOOOVVVVVVVV
POOOOOOOOOOOVVVVVVVV
POOOOOOOOOOOVVVVVVVV
POOOOOOOOOOOVVVVVVVV
POOOOOOOOOOOVVVVVVVV
POOOOOOOOOOOVVVVVVVV
POOOOOOOOOOOWVVVVVVV
POOOOOOVOOOOWVVVVVVV
POOOOOOVOOOOWVVVVVVV
POOOOXXVOOOOWVVVVVVV
POOOOXXVOOOOWVVVVVVV
POOOOOOVOOOOWVVVVVVV
POOOOOOVOOOOWVVVVVVV
POOOOOOOOOOOWVVVVVVV
POOOOOOOOOOOVVVVVVVV
POOOOOOOOOOOVVVVVVVV
POOOOOOOOOOOVVVVVVVV
POOOOOOOOOOOVVVVVVVV
POOOOOOOOOOOVVVVVVVV
POOOOOOOOOOOVVVVVVVV
POOOOOOOOOOOVVVVVVVV
VVVVVVVVVZZZVVVVVVVV
VOOOZZZZVZZZVVVVVVVV
VOOOZZZZVZZZVVVVVVVV
VOOOZZZZZZZZVVVVVVVV
VOOOZZZZZZZZVVVVVVVV
VOOOZZZZZZZZVVVVVVVV
VOOOZZZZZZZZVVVVVVVV
VOOOZZZZZZZZVVVVVVVV
VVVVVVVVVVVVVVVVVVVV
VVVVVVVVVVVVVVVVVVVV
VVVVVVVVVVVVVVVVVVVV
VVVVVVVVVVVVVVVVVVVV
VVVVVVVVVVVVVVVVVVVV
VVVVVVVVVVVVVVVVVVVV
VVVVVVVVVVVVVVVVVVVV
VVVVVVVVVVVVVVVVVVVV
VVVVVVVVVVVVVVVVVVVV
VVVVVVVVVVVVVVVVVVVV
VVVVVVVVVVVVVVVVVVVV
VVVVVVVVVVVVVVVVVVVV
VVVVVVVVVVVVVVVVVVVV
VVVVVVVVVVVVVVVVVVVV
