SSSSSSSOOOOOOOOOOO
SSSSSSSOOOOOOOOOOO
SSSSSSSOOOOOOOOOOO
SSSSSSSOOOOOOOOOOO
SSSSSSSOOOOOOOOOOO
SSSSSSSOOOOOOOOOOO
SSSSSSSOOOOOOOOOOO
SSSSSSSOOOOOOOOOOO
SSSSSSSOOOOOOOOOOO
SSSSSSSOOOOOOOOOOO
SSSSSSSOOOOOOOOOOO
SSSSSSWOOOOOOOOOOO
SSSSSSWOOOOOOOOOOO
SSSSSSWOOOOOOOOOOO
SSSSSSWOOOOOOOOOOO
SSSSSSWOOOOOOOOOOO
SSSSSSWOOOOOOOOOOO
SSSSSSSOOOOOOOOOOO
SSSSSSSOOOOOOOOOOO
SSSSSSSOOOOOOOOOOO
SSSSSSSOOOOOOOOOOO
SSSSSSSOOOOSOOOOOO
SSSSSSSOOOOSOOOOOO
SSSSSSSOOOOSOOOOOO
SSSSSSSOOOOSOOOOOO
SSSSSSSOOOOSOOOOOO
SSSSSSSOOOOSOOOOOO
SSSSSSWOOOOSOOOOOO
SSSSSSWOOOOSOOOOOO
SSSSSSWOOOSOOOOOOO
SSSSSSSOOOSOOOOOOO
SSSSSSSOOOSOOOOOOO
SSSSSSSOOOOOOOOOOO
SSSSSSSOOOOOOOOOOO
SSSSSSSOOOOOOOOOOO
SSSSSSSOOOOOOOOOOO
SSSSSSSOOOOOOOOOOO
SSSSSSSOOOOOOOOOOO
SSSSSSSOOOOOOOOOOO
SSSSSSSOOOOOOOOOOO
SSSSSSSOOOOOOOOOOO
SSSSSSSOOOOOOOOOOO
SSSSSSSOOOOOOOOOOO
SSSSSSSOOOOOOOOOOO
SSSSSSSOOOOOOOOOOO
SSSSSSSOOOOOOOOOOO
SSSSSSSOOOOOOOOOOO
SSSSSSSOOOOOOOOOOO
SSSSSSSOOOOOOOOOOO
SSSSSSSOOOOSSOOOOO
SSSSSSSOOOOSSOOOOO
SSSSSSSOOOOSWOOOOO
SSSSSSSOOOOSWOOOOO
SSSSSSSOOOOSSOOOOO
SSSSSSSOOOOSSOOOOO
SSSSSSSOOOSOOOOOOO
SSSSSSSOOOSOOOOOOO
SSSSSSSOOOSOOOOOOO
SSSSSSSOOOSOOOOOOO
SSSSSSSOOOSOOOOOOO
SSSSSSSOOOOOOOOOOO
SSSSSSSOOOOOOOOOOO
SSSSSSSOOOOOOOOOOO
SSSSSSSOOOOOOOOOOO
SSSSSSSOOOOOOOOOOO
SSSSSSSOOOOOOOOOOO
SSSSSSSOOOOOOOOOOO
SSSSSSSOOOOOOOOOOO
SSSSSSSOOOOOOOOOOO
SSSSSSSOOOOOOOOOOO
SSSSSSSOOOOOOOOOOO
SSSSSSSOOOOOOOOOOO
SSSSSSSOOOOOOOOOOO
SSSSSSSOOOOOOOOOOO
SSSSSSSOOOOOOOOOOO
SSSSSSSOOOOOOOOOOO
SSSSSSSOOSOOOOOOOO
SSSSSSSOOSOOOOOOOO
SSSSSSSOOSOOOOOOOO
SSSSSSSOOSOOOOOOOO
SSSSSSSOOSOOOOOOOO
SSSSSSSOOSOOOOOOOO
SSSSSSSOOOOOOOOOOO
SSSSSSSOOOOOOOOOOO
SSSSSSSOOOOOOOOOOO
SSSSSSSOOOOOOOOOOO
SSSSSSSOOOOOOOOOOO
SSSSSSSOOOOOOOOOOO
SSSSSSSOOOOOOOOOOO
SSSSSSSOOOOOOOOOOO
SSSSSSSOOOOOOOOOOO
SSSSSSSOOOOOOOOOOO
SSSSSSSOOOOOOOOOOO
SSSSSSSOOOOOOOOOOO
SSSSSSSOOOOOOOOOOO
SSSSSSSXXXXOOOOOOO
SSSSSSSXXXXOOOOOOO
SSSSSSSXXXXOOOOOOO
SSSSSSSXXXXOOOOOOO
