OOOOOOOOOOOSSSSSSS
OOOOOOHTTOBSSSSSSS
OOOOOOZZZZZSSSSSSS
OOOOOOZZZZZSSSSSSS
OOOOOOZZZZZSSSSSSS
OOOOOOOOOOOSSSSSSS
OOOOOOOOOOOSSSSSSS
OOOOOOOOOOOSSSSSSS
OOOOOOOOOOOSSSSSSS
OOOOOOOOOOOSSSSSSS
OOOOOOOOOOOSSSSSSS
OOOOOOOOOOOWSSSSSS
OOOOOOOOOOOWSSSSSS
OOOOOOOOOOOWSSSSSS
OOOOOOOOOOOWSSSSSS
OOOOOOOOOOOWSSSSSS
OOOOOOOOOOOWSSSSSS
OOOOOOOOOOOSSSSSSS
OOOOOOOOOOOSSSSSSS
OOOOOOOOOOOSSSSSSS
OOOOOOOOOOOSSSSSSS
OOOOOOSZZZZSSSSSSS
OOOOOOSZSSSSSSSSSS
OOOOOOSZZSSSSSSSSS
OOOOOOSZZZSSSSSSSS
OOOOOOSZZZZSSSSSSS
OOOOOOSZZZZSSSSSSS
OOOOOOSZZZZWSSSSSS
OOOOOOSZZZZWSSSSSS
OOOOOOOSZZZWSSSSSS
OOOOOOOSZZZSSSSSSS
OOOOOOOSZZZSSSSSSS
OOOOOOOOOOOSSSSSSS
OOOOOOOOOOOSSSSSSS
OOOOOOOOOOOSSSSSSS
OOOOOOOOOOOSSSSSSS
OOOOOOOOOOOSSSSSSS
OOOOOOOOOOOSSSSSSS
OOOOOOOOOOOSSSSSSS
OOOOOOOOOOOSSSSSSS
OOOOOOOOOOOSSSSSSS
OOOOOOOOOOOSSSSSSS
OOOOOOOOOOOSSSSSSS
OOOOOOOOOOOSSSSSSS
OOOOOOOOOOOSSSSSSS
OOOOOOOOOOOSSSSSSS
OOOOOOOOOOOSSSSSSS
OOOOOOOOOOOSSSSSSS
OOOOOOOOOOOSSSSSSS
OOOOOSSZZZZOSSSSSS
OOOOOSSZZZZOSSSSSS
OOOOOWSZZZZOSSSSSS
OOOOOWSZZZZOSSSSSS
OOOOOSSZZZZOSSSSSS
OOOOOSSZZZZOSSSSSS
OOOOOOOSZZZOSSSSSS
OOOOOOOSZZZOSSSSSS
OOOOOOOSZZZOSSSSSS
OOOOOOOSZZZOSSSSSS
OOOOOOOSZZZOSSSSSS
OOOOOOOOOOOOSSSSSS
OOOOOOOOOOOOSSSSSS
OOOOOOOOOOOOSSSSSS
OOOOOOOOOOOOSSSSSS
OOOOOOOOOOOOSSSSSS
OOOOOOOOOOOOSSSSSS
OOOOHTTTTOBOSSSSSS
OOOOZZZZZZZSSSSSSS
OOOOZZZZZZZSSSSSSS
OOOOZZZZZZZSSSSSSS
OOOOOOOOOOOSSSSSSS
OOOOOOOOOOOSSSSSSS
OOOOOOOOOOOSSSSSSS
OOOOOOOOOOOSSSSSSS
OOOOOOOOOOOSSSSSSS
OOOOOOOOOOOSSSSSSS
OOOOOOOOSZZSSSSSSS
OOOOOOOOSZZSSSSSSS
OOOOOOOOSZZSSSSSSS
OOOOOOOOSZZSSSSSSS
OOOOOOOOSZZSSSSSSS
OOOOOOOOSZZSSSSSSS
OOOOOOOOOOOSSSSSSS
OOOOOOOOOOOSSSSSSS
OOOOOOOOOOOSSSSSSS
OOOOOOOOOOOSSSSSSS
OOOOOOOOOOOSSSSSSS
OOOOOOOOOOOSSSSSSS
OOOOOOOOOOOSSSSSSS
OOOOOOOOOOOSSSSSSS
OOOOOOOOOOOSSSSSSS
OOOOOOOOOOOSSSSSSS
OOOOOOOOOOOSSSSSSS
OOOOOOOOOOOSSSSSSS
OOOOOOOOOOOSSSSSSS
OOOOOOOXXXXSSSSSSS
OOOOOOOXXXXSSSSSSS
OOOOOOOXXXXSSSSSSS
OOOOOOOXXXXSSSSSSS
