OOOOOOOXXXXSSSSSSS
OOOOOOOXXXXSSSSSSS
OOOOOOOXXXXSSSSSSS
OOOOOOOXXXXSSSSSSS
OOOOOOOOOOOSSSSSSS
OOOOOOOOOOOSSSSSSS
OOOOOOOOOOOSSSSSSS
OOOOOOOOOOOSSSSSSS
OOOOOOOOOOOSSSSSSS
OOOOOOOOOOOSSSSSSS
OOOOOOOOOOOSSSSSSS
OOOOOOOOOOOSSSSSSS
OOOOOOOOOOOSSSSSSS
OOOOOOOOOOOSSSSSSS
OOOOOOOOOOOSSSSSSS
OOOOOOOOOOOSSSSSSS
OOOOOOOOOOOSSSSSSS
OOOOOOOOSOOSSSSSSS
OOOOOOOOSOOSSSSSSS
OOOOOOOOSOOSSSSSSS
OOOOOOOOSOOSSSSSSS
OOOOOOOOSOOSSSSSSS
OOOOOOOOSOOSSSSSSS
OOOOOOOOOOOSSSSSSS
OOOOOOOOOOOSSSSSSS
OOOOOOOOOOOSSSSSSS
OOOOOOOOOOOSSSSSSS
OOOOOOOOOOOSSSSSSS
OOOOOOOOOOOSSSSSSS
OOOOOOOOOOOSSSSSSS
OOOOOOOOOOOSSSSSSS
OOOOOOOOOOOSSSSSSS
OOOOOOOOOOOSSSSSSS
OOOOOOOOOOOSSSSSSS
OOOOOOOOOOOSSSSSSS
OOOOOOOOOOOSSSSSSS
OOOOOOOOOOOSSSSSSS
OOOOOOOOOOOSSSSSSS
OOOOOOOOOOOSSSSSSS
OOOOOOOSOOOSSSSSSS
OOOOOOOSOOOSSSSSSS
OOOOOOOSOOOSSSSSSS
OOOOOOOSOOOSSSSSSS
OOOOOOOSOOOSSSSSSS
OOOOOSSOOOOSSSSSSS
OOOOOSSOOOOSSSSSSS
OOOOOWSOOOOSSSSSSS
OOOOOWSOOOOSSSSSSS
OOOOOSSOOOOSSSSSSS
OOOOOSSOOOOSSSSSSS
OOOOOOOOOOOSSSSSSS
OOOOOOOOOOOSSSSSSS
OOOOOOOOOOOSSSSSSS
OOOOOOOOOOOSSSSSSS
OOOOOOOOOOOSSSSSSS
OOOOOOOOOOOSSSSSSS
OOOOOOOOOOOSSSSSSS
OOOOOOOOOOOSSSSSSS
OOOOOOOOOOOSSSSSSS
OOOOOOOOOOOSSSSSSS
OOOOOOOOOOOSSSSSSS
OOOOOOOOOOOSSSSSSS
OOOOOOOOOOOSSSSSSS
OOOOOOOOOOOSSSSSSS
OOOOOOOOOOOSSSSSSS
OOOOOOOOOOOSSSSSSS
OOOOOOOOOOOSSSSSSS
OOOOOOOSOOOSSSSSSS
OOOOOOOSOOOSSSSSSS
OOOOOOOSOOOWSSSSSS
OOOOOOSOOOOWSSSSSS
OOOOOOSOOOOWSSSSSS
OOOOOOSOOOOSSSSSSS
OOOOOOSOOOOSSSSSSS
OOOOOOSOOOOSSSSSSS
OOOOOOSOOOOSSSSSSS
OOOOOOSOOOOSSSSSSS
OOOOOOSOOOOSSSSSSS
OOOOOOOOOOOSSSSSSS
OOOOOOOOOOOSSSSSSS
OOOOOOOOOOOSSSSSSS
OOOOOOOOOOOSSSSSSS
OOOOOOOOOOOWSSSSSS
OOOOOOOOOOOWSSSSSS
OOOOOOOOOOOWSSSSSS
OOOOOOOOOOOWSSSSSS
OOOOOOOOOOOWSSSSSS
OOOOOOLLLOOWSSSSSS
OOOOOOLLLOOSSSSSSS
OOOOOLLOOOOSSSSSSS
OOOOOLBOOOOSSSSSSS
OOOOOLLBOOOSSSSSSS
OOOOOOLOBBBSSSSSSS
OOOOOOOLOOOSSSSSSS
OOOOOOOOOOOSSSSSSS
OOOOOOOXXXXSSSSSSS
OOOOOOOXXXXSSSSSSS
OOOOOOOXXXXSSSSSSS
OOOOOOOXXXXSSSSSSS
