OOOOOOOOOOOSSSSSSS
OOOOOOOOOOOSSSSSSS
OOOOOOOOOOOSSSSSSS
OOOOOOOOOOOSSSSSSS
OOOOOOOOOOOSSSSSSS
OOOOOOOOOOOSSSSSSS
OOOOOOOOOOOSSSSSSS
OOOOOHTTTOBSSSSSSS
OOOOOZZZZZZSSSSSSS
OOOOOZZZZZZSSSSSSS
OOOOOZZZZZZSSSSSSS
OOOOOOOOOOOWSSSSSS
OOOOOOOOOOOWSSSSSS
OOOOOOOOOOOWSSSSSS
OOOOOOOOOOOWSSSSSS
OOOOOOOOOOOWSSSSSS
OOOOOOOOOOOWSSSSSS
OOOOOOOOOOOSSSSSSS
OOOOOOOOOOOSSSSSSS
OOOOOOOOOOOSSSSSSS
OOOOOOOOOOOSSSSSSS
OOOOOOSZZZZSSSSSSS
OOOOOOSZZZZSSSSSSS
OOOOOOSZZZZSSSSSSS
OOOOOOSZZZZSSSSSSS
OOOOOOSZZZZSSSSSSS
OOOOOOSZZZZSSSSSSS
OOOOOOSZZZZWSSSSSS
OOOOOOSZZZZWSSSSSS
OOOOOOOSZZZWSSSSSS
OOOOOOOSZZZSSSSSSS
OOOOOOOSZZZSSSSSSS
OOOOOOOOOOOSSSSSSS
OOOOOOOOOOOSSSSSSS
OOOOOOOOOOOSSSSSSS
OOOOOOOOOOOSSSSSSS
OOOOOOOOOOOSSSSSSS
OOOOOOOOOOOSSSSSSS
OOOOOOOOOOOSSSSSSS
OOOOOOOHTOBSSSSSSS
OOOOOOOZZZZSSSSSSS
OOOOOOOZZZZSSSSSSS
OOOOOOOZZZZSSSSSSS
OOOOOOOOOOOSSSSSSS
OOOOOOOOOOOSSSSSSS
OOOOOOOOOOOSSSSSSS
OOOOOOOOOOOSSSSSSS
OOOOOOOOOOOSSSSSSS
OOOOOOOOOOOSSSSSSS
OOOOOSSZZZZSSSSSSS
OOOOOSSZZZZSSSSSSS
OOOOOWSZZZZSSSSSSS
OOOOOWSZZZZSSSSSSS
OOOOOSSZZZZSSSSSSS
OOOOOSSZZZZSSSSSSS
OOOOOOOSZZZSSSSSSS
OOOOOOOSZZZSSSSSSS
OOOOOOOSZZZSSSSSSS
OOOOOOOSZZZSSSSSSS
OOOOOOOSZZZSSSSSSS
OOOOOOOOOOOSSSSSSS
OOOOOOOOOOOSSSSSSS
OOOOOOOOOOOSSSSSSS
OOOOOOOOOOOSSSSSSS
OOOOOOOOOOOSSSSSSS
OOOOOOOOOOOSSSSSSS
OOOOOOOOOOOSSSSSSS
OOOOOOOOOOOSSSSSSS
OOOOOOOOOOOSSSSSSS
OOOOOOOOOOOSSSSSSS
OOOOOOOOOOOSSSSSSS
OOOOOOOOOOOSSSSSSS
OOOOOOOOOOOSSSSSSS
OOOOOOOOOOOSSSSSSS
OOOOOOOOOOOSSSSSSS
OOOOOOOOOOOSSSSSSS
OOOOOOOOSZZSSSSSSS
OOOOOOOOSZZSSSSSSS
OOOOOOOOSZZSSSSSSS
OOOOOOOOSZZSSSSSSS
OOOOOOOOSZZSSSSSSS
OOOOOOOOSZZSSSSSSS
OOOOOOOOOOOSSSSSSS
OOOOOOOOOOOSSSSSSS
OOOOOOOOOOOSSSSSSS
OOOOOOOOOOOSSSSSSS
OOOOOOOOOOOSSSSSSS
OOOOOOOOOOOSSSSSSS
OOOOOOOOOOOSSSSSSS
OOOOOOOOOOOSSSSSSS
OOOOOOOOOOOSSSSSSS
OOOOOOOOOOOSSSSSSS
OOOOOOOOOOOSSSSSSS
OOOOOOOOOOOSSSSSSS
OOOOOOOOOOOSSSSSSS
OOOOOOOXXXXSSSSSSS
OOOOOOOXXXXSSSSSSS
OOOOOOOXXXXSSSSSSS
OOOOOOOXXXXSSSSSSS
