OOOOOOOOOOOSSSSSSS
OOOOOOOOOOOSSSSSSS
OOOOOOOOOOOSSSSSSS
OOOOOOOOOOOSSSSSSS
OOOOOOOOOOOSSSSSSS
OOOOOOOOOOOSSSSSSS
OOOOOOOOOOOSSSSSSS
OOOOOOOOOOOSSSSSSS
OOOOOOOOOOOSSSSSSS
OOOOOOOOOOOSSSSSSS
OOOOOOOOOOOSSSSSSS
OOOOOOOOOOOSSSSSSS
OOOOOOOOOOOSSSSSSS
OOOOOOOOOOOSSSSSSS
OOOOOOOOOOOSSSSSSS
OOOOOOOOOOOSSSSSSS
OOOOOOOOOOOSSSSSSS
OOOOOOOOOOOSSSSSSS
OOOOOOOOOOOSSSSSSS
OOOOOOOOOOOSSSSSSS
OOOOOOOOOOOSSSSSSS
OOOOOOOOOOOSSSSSSS
OOOOOOOOOOOSSSSSSS
OOOOOOOOOOOSSSSSSS
OOOOOOOOOOOSSSSSSS
OOOOOOOOOOOSSSSSSS
OOOOOOOOOOOSSSSSSS
OOOOOOOOOOOSSSSSSS
OOOOOOOOOOOSSSSSSS
OOOOOOOOOOOSSSSSSS
OOOOOOOOOOOSSSSSSS
OOOOOOOOOOOWSSSSSS
OOOOOOOOOOOWSSSSSS
OOOOOOOOSOOWSSSSSS
OOOOOOOOSOOWSSSSSS
OOOOOOOOSOOWSSSSSS
OOOOOOOOSOOWSSSSSS
OOOOOOOOSOOWSSSSSS
OOOOOOOOSOOWSSSSSS
OOOOOOOOSOOWSSSSSS
OOOOOOOOSOOWSSSSSS
OOOOOOOOSOOWSSSSSS
OOOOOOOOSOOWSSSSSS
OOOOOOOOOOOWSSSSSS
OOOOOOOOOOOSSSSSSS
OOOOOOOOOOOSSSSSSS
OOOOOOOOOOOSSSSSSS
OOOOOOOOOOOSSSSSSS
OOOOOOOOOOOSSSSSSS
OOOOOOOOOOOSSSSSSS
OOOOOOOOOOOSSSSSSS
OOOOOOOOOOOSSSSSSS
OOOOOOOOOOOSSSSSSS
OOOOOOOOOOOSSSSSSS
OOOOOOOOOOOSSSSSSS
OOOOOOOOOOOSSSSSSS
OOOOOOOOOOOSSSSSSS
OOOOOOOOOOOSSSSSSS
OOOOOOOOOOOSSSSSSS
OOOOOOOOSOZSSSSSSS
OOOOOOOOSOZSSSSSSS
OOOOOOOOSOZSSSSSSS
OOOOOOOOSOZSSSSSSS
OOOOOOOOSOZSSSSSSS
OOOOOOOOOOOSSSSSSS
OOOOOOOOOOOSSSSSSS
OOOOOOOOOOOSSSSSSS
OOOOOOOOOOOSSSSSSS
OOOOOOSOOOZSSSSSSS
OOOOOOSOOOZSSSSSSS
OOOOOOSOOOZSSSSSSS
OOOOOOSOOOZSSSSSSS
OOOOOOSOOOZSSSSSSS
OOOOOOOOOOOSSSSSSS
OOOOOOOOOOOSSSSSSS
OOOOOOOOOOOSSSSSSS
OOOOOOOOOOOSSSSSSS
OOOOOOOOOOOSSSSSSS
OOOOOOOOOOOSSSSSSS
OOOOOOOOOOOSSSSSSS
SSSOOZSOOOZSSSSSSS
SOOOOZSOOOZSSSSSSS
SOOOOZSOOOZSSSSSSS
SOOOOZSOOOZSSSSSSS
SOOOZZSOOOZSSSSSSS
SOOOZSSOOOZSSSSSSS
SOOOZSOOOOZSSSSSSS
SOOOZSOOOOZSSSSSSS
OOOOOSOOOOZSSSSSSS
OOOOOSOOOOZSSSSSSS
OOOOOSOOOOZSSSSSSS
OOOOSSOOOOZSSSSSSS
OOOOSOOOOOZSSSSSSS
OOOOSOOOOOZSSSSSSS
OOOOSOOOOOZSSSSSSS
OOOOSOOOOOZSSSSSSS
XXXXSOOOOOZSSSSSSS
XXXXSOOOOOZSSSSSSS
XXXXSOOOOOZSSSSSSS
XXXXSOOOOOZSSSSSSS
