OOOOOOOOOOOSSSSSSS
OOOOOOOOOOOSSSSSSS
OOOOOOOOOOOSSSSSSS
OOOOOOOOOOOSSSSSSS
OOOOOOOOOOOSSSSSSS
OOOOOOHTTOBSSSSSSS
OOOOOOZZZZZSSSSSSS
OOOOOOZZZZZSSSSSSS
OOOOOOZZZZZSSSSSSS
OOOOOOOOOOOSSSSSSS
OOOOOOOOOOOSSSSSSS
OOOOOOOOOOOSSSSSSS
OOOOOOOOOOOSSSSSSS
OOOOOOOOOOOSSSSSSS
OOOOOOOOOOOSSSSSSS
OOOOOOOOOOOSSSSSSS
OOOOOOOOOOOSSSSSSS
OOOOOOOOOOOSSSSSSS
OOOOOOOOOOOSSSSSSS
OOOOOOOOOOOSSSSSSS
OOOOOOOOOOOSSSSSSS
OOOOOOOOOOOSSSSSSS
OOOOOOOOOOOSSSSSSS
OOOOOOOOOOOSSSSSSS
OOOOOOOOOOOSSSSSSS
OOOOOOOOOOOSSSSSSS
OOOOOOOOOOOSSSSSSS
OOOOOOOOOOOSSSSSSS
OOOOOOOOOOOSSSSSSS
OOOOOOOOOOOSSSSSSS
OOOOOOOOOOOSSSSSSS
OOOOOOOOOOOWSSSSSS
OOOOOOOOOOOWSSSSSS
OOOOOOOOSZZWSSSSSS
OOOOOOOOSZZWSSSSSS
OOOOOOOOSZZWSSSSSS
OOOOOOOOSZZWSSSSSS
OOOOOOOOSZZWSSSSSS
OOOOOOOOSZZWSSSSSS
OOOOOOOOSZZWSSSSSS
OOOOOOOOSZZWSSSSSS
OOOOOOOOSZZWSSSSSS
OOOOOOOOSZZWSSSSSS
OOOOOOOOOOOWSSSSSS
OOOOOOOOOOOSSSSSSS
OOOOOOOOOOOSSSSSSS
OOOOOOOOOOOSSSSSSS
OOOOOOOOOOOSSSSSSS
OOOOOOOOOOOSSSSSSS
OOOOOOOOOOOSSSSSSS
OOOOOOOOOOOSSSSSSS
OOOOOOOOOOOSSSSSSS
OOOOOOOOOOOSSSSSSS
OOOOOOOOOOOSSSSSSS
OOOOOOOOOOOSSSSSSS
OOOOOOOOOOOSSSSSSS
OOOOOOOOOOOSSSSSSS
OOOOOOOOOOOSSSSSSS
OOOOOOOOOOOSSSSSSS
OOOOOOOOSZZSSSSSSS
OOOOOOOOSZZSSSSSSS
OOOOOOOOSZZSSSSSSS
OOOOOOOOSZZSSSSSSS
OOOOOOOOSZZSSSSSSS
OOOOOOOOOOOSSSSSSS
OOOOOOOOOOOSSSSSSS
OOOOOOOOOOOSSSSSSS
OOOOOOOOOOOSSSSSSS
OOOOOOSZZZZSSSSSSS
OOOOOOSZZZZSSSSSSS
OOOOOOSZZZZSSSSSSS
OOOOOOSZZZZSSSSSSS
OOOOOOSZZZZSSSSSSS
OOOOOOOOOOOSSSSSSS
OOOOOOOOOOOSSSSSSS
OOOOOOOOOOOSSSSSSS
OOOOOOOOOOOSSSSSSS
OOOOOOOOOOOSSSSSSS
OOOOOOOOOOOSSSSSSS
OOOOOOOOOOOSSSSSSS
SSSZZZSZZZZSSSSSSS
SZZZZZSZZZZSSSSSSS
SZZZZZSZZZZSSSSSSS
SZZZZZSZZZZSSSSSSS
SZZZZZSZZZZSSSSSSS
SZZZZSSZZZZSSSSSSS
SZZZZSZZZZZSSSSSSS
SZZZZSZZZZZSSSSSSS
OOOOOSZZZZZSSSSSSS
OOOOOSZZZZZSSSSSSS
OOOOOSZZZZZSSSSSSS
OOOOSSZZZZZSSSSSSS
OOOOSZZZZZZSSSSSSS
OOOOSZZZZZZSSSSSSS
OOOOSZZZZZZSSSSSSS
OOOOSZZZZZZSSSSSSS
XXXXSZZZZZZSSSSSSS
XXXXSZZZZZZSSSSSSS
XXXXSZZZZZZSSSSSSS
XXXXSZZZZZZSSSSSSS
