OOOOOOOOOOOSSSSSSS
OOOOOOOOOOOSSSSSSS
OOOOOOOOOOOSSSSSSS
OOOOOOOOOOOSSSSSSS
OOOOOOOOOOOSSSSSSS
OOOOOOOOOOOSSSSSSS
OOOOOOOOOOOSSSSSSS
OOOOOOOOOOOSSSSSSS
OOOOOOOOOOOSSSSSSS
OOOOOOOOOOOSSSSSSS
OOOOOOOOOOOSSSSSSS
OOOOOOOOOOOWSSSSSS
OOOOOOOOOOOWSSSSSS
OOOOOOOOOOOWSSSSSS
OOOOOOOOOOOWSSSSSS
OOOOOOOOOOOWSSSSSS
OOOOOOOOOOOWSSSSSS
OOOOOOOOOOOSSSSSSS
OOOOOOOOOOOSSSSSSS
OOOOOOOOOOOSSSSSSS
OOOOOOOOOOOSSSSSSS
OOOOOOSZZZZSSSSSSS
OOOOOOSZSSSSSSSSSS
OOOOOOSOZSSSSSSSSS
OOOOOOSOOZSSSSSSSS
OOOOOOSOOOZSSSSSSS
OOOOOOSOOOZSSSSSSS
OOOOOOSOOOZWSSSSSS
OOOOOOSOOOZWSSSSSS
OOOOOOOSOOZWSSSSSS
OOOOOOOSOOZSSSSSSS
OOOOOOOSOOZSSSSSSS
OOOOOOOOOOOSSSSSSS
OOOOOOOOOOOSSSSSSS
OOOOOOOOOOOSSSSSSS
OOOOOOOOOOOSSSSSSS
OOOOOOOOOOOSSSSSSS
OOOOOOOOOOOSSSSSSS
OOOOOOOOOOOSSSSSSS
OOOOOOOOOOOSSSSSSS
OOOOOOOOOOOSSSSSSS
OOOOOOOOOOOSSSSSSS
OOOOOOOOOOOSSSSSSS
OOOOOOOOOOOSSSSSSS
OOOOOOOOOOOSSSSSSS
OOOOOOOOOOOSSSSSSS
OOOOOOOOOOOSSSSSSS
OOOOOOOOOOOSSSSSSS
OOOOOOOOOOOSSSSSSS
OOOOOSSOOOZOSSSSSS
OOOOOSSOOOZOSSSSSS
OOOOOWSOOOZOSSSSSS
OOOOOWSOOOZOSSSSSS
OOOOOSSOOOZOSSSSSS
OOOOOSSOOOZOSSSSSS
OOOOOOOSOOZOSSSSSS
OOOOOOOSOOZOSSSSSS
OOOOOOOSOOZOSSSSSS
OOOOOOOSOOZOSSSSSS
OOOOOOOSOOZOSSSSSS
OOOOOOOOOOOOSSSSSS
OOOOOOOOOOOOSSSSSS
OOOOOOOOOOOOSSSSSS
OOOOOOOOOOOOSSSSSS
OOOOOOOOOOOOSSSSSS
OOOOOOOOOOOOSSSSSS
OOOOOOOOOOOOSSSSSS
OOOOOOOOOOOSSSSSSS
OOOOOOOOOOOSSSSSSS
OOOOOOOOOOOSSSSSSS
OOOOOOOOOOOSSSSSSS
OOOOOOOOOOOSSSSSSS
OOOOOOOOOOOSSSSSSS
OOOOOOOOOOOSSSSSSS
OOOOOOOOOOOSSSSSSS
OOOOOOOOOOOSSSSSSS
OOOOOOOOSOZSSSSSSS
OOOOOOOOSOZSSSSSSS
OOOOOOOOSOZSSSSSSS
OOOOOOOOSOZSSSSSSS
OOOOOOOOSOZSSSSSSS
OOOOOOOOSOZSSSSSSS
OOOOOOOOOOOSSSSSSS
OOOOOOOOOOOSSSSSSS
OOOOOOOOOOOSSSSSSS
OOOOOOOOOOOSSSSSSS
OOOOOOOOOOOSSSSSSS
OOOOOOOOOOOSSSSSSS
OOOOOOOOOOOSSSSSSS
OOOOOOOOOOOSSSSSSS
OOOOOOOOOOOSSSSSSS
OOOOOOOOOOOSSSSSSS
OOOOOOOOOOOSSSSSSS
OOOOOOOOOOOSSSSSSS
OOOOOOOOOOOSSSSSSS
OOOOOOOOOOOSSSSSSS
OOOOOOOOOOOSSSSSSS
OOOOOOOOOOOSSSSSSS
OOOOOOOOOOOSSSSSSS
