OOOOOOOOOOOSSSSSSS
OOOOOOOOOOOSSSSSSS
OOOOOOOOOOOSSSSSSS
OOOOOOOOOOOSSSSSSS
OOOOOOOOOOOSSSSSSS
OOOOOOOOOOOSSSSSSS
OOOOOOOOOOOSSSSSSS
OOOOOOOOOOOSSSSSSS
OOOOOOOOOOOSSSSSSS
OOOOOOOOOOOSSSSSSS
OOOOOOOOOOOSSSSSSS
OOOOOOOOOOOSSSSSSS
OOOOOOOOOOOSSSSSSS
OOOOOOOOOOOSSSSSSS
OOOOOOOOOOOSSSSSSS
OOOOOOOOOOOSSSSSSS
OOOOOOOOOOOSSSSSSS
OOOOOOOOSOOSSSSSSS
OOOOOOOOSOOSSSSSSS
OOOOOOOOSOOSSSSSSS
OOOOOOOOSOOSSSSSSS
OOOOOOOOSOOSSSSSSS
OOOOOOOOSOOSSSSSSS
OOOOOOOOOOOSSSSSSS
OOOOOOOOOOOSSSSSSS
OOOOOOOOOOOSSSSSSS
OOOOOOOOOOOSSSSSSS
OOOOOOOOOOOSSSSSSS
OOOOOOOOOOOSSSSSSS
OOOOOOOOOOOSSSSSSS
OOOOOOOOOOOSSSSSSS
OOOOOOOOOOOSSSSSSS
OOOOOOOOOOOOSSSSSS
OOOOOOOOOOOOSSSSSS
OOOOOOOOOOOOSSSSSS
OOOOOOOOOOOOSSSSSS
OOOOOOOOOOOOSSSSSS
OOOOOOOOOOOOSSSSSS
OOOOOOOOOOOOSSSSSS
OOOOOOOSOOOOSSSSSS
OOOOOOOSOOOOSSSSSS
OOOOOOOSOOOOSSSSSS
OOOOOOOSOOOOSSSSSS
OOOOOOOSOOOOSSSSSS
OOOOOSSOOOOOSSSSSS
OOOOOSSOOOOOSSSSSS
OOOOOWSOOOOOSSSSSS
OOOOOWSOOOOOSSSSSS
OOOOOSSOOOOOSSSSSS
OOOOOSSOOOOOSSSSSS
OOOOOOOOOOOSSSSSSS
OOOOOOOOOOOSSSSSSS
OOOOOOOOOOOSSSSSSS
OOOOOOOOOOOSSSSSSS
OOOOOOOOOOOSSSSSSS
OOOOOOOOOOOSSSSSSS
OOOOOOOOOOOSSSSSSS
OOOOOOOOOOOSSSSSSS
OOOOOOOOOOOSSSSSSS
OOOOOOOOOOOSSSSSSS
OOOOOOOOOOOSSSSSSS
OOOOOOOOOOOSSSSSSS
OOOOOOOOOOOSSSSSSS
OOOOOOOOOOOSSSSSSS
OOOOOOOOOOOSSSSSSS
OOOOOOOOOOOSSSSSSS
OOOOOOOOOOOSSSSSSS
OOOOOOOSOOOSSSSSSS
OOOOOOOSOOOSSSSSSS
OOOOOOOSOOOWSSSSSS
OOOOOOSOOOOWSSSSSS
OOOOOOSOOOOWSSSSSS
OOOOOOSOOOOSSSSSSS
OOOOOOSOOOOSSSSSSS
OOOOOOSOOOSSSSSSSS
OOOOOOSOOSSSSSSSSS
OOOOOOSOSSSSSSSSSS
OOOOOOSOOOOSSSSSSS
OOOOOOOOOOOSSSSSSS
OOOOOOOOOOOSSSSSSS
OOOOOOOOOOOSSSSSSS
OOOOOOOOOOOSSSSSSS
OOOOOOOOOOOWSSSSSS
OOOOOOOOOOOWSSSSSS
OOOOOOOOOOOWSSSSSS
OOOOOOOOOOOWSSSSSS
OOOOOOOOOOOWSSSSSS
OOOOOOOOOOOWSSSSSS
OOOOOOOOOOOSSSSSSS
OOOOOOOOOOOSSSSSSS
OOOOOOOOOOOSSSSSSS
OOOOOOOOOOOSSSSSSS
OOOOOOOOOOOSSSSSSS
OOOOOOOOOOOSSSSSSS
OOOOOOOOOOOSSSSSSS
OOOOOOOOOOOSSSSSSS
OOOOOOOOOOOSSSSSSS
OOOOOOOOOOOSSSSSSS
OOOOOOOOOOOSSSSSSS
