SSSSSSSOOOOOOOOOOO
SSSSSSSOOOOOOOOOOO
SSSSSSSOOOOOOOOOOO
SSSSSSSOOOOOOOOOOO
SSSSSSSOOOOOOOOOOO
SSSSSSSOOOOOOOOOOO
SSSSSSSOOOOOOOOOOO
SSSSSSSOOOOOOOOOOO
SSSSSSSOOOOOOOOOOO
SSSSSSSOOOOOOOOOOO
SSSSSSSOOOOOOOOOOO
SSSSSSWOOOOOOOOOOO
SSSSSSWOOOOOOOOOOO
SSSSSSWOOOOOOOOOOO
SSSSSSWOOOOOOOOOOO
SSSSSSWOOOOOOOOOOO
SSSSSSWOOOOOOOOOOO
SSSSSSSOOOOOOOOOOO
SSSSSSSOOOOOOOOOOO
SSSSSSSOOOOOOOOOOO
SSSSSSSOOOOOOOOOOO
SSSSSSSOOOOSOOOOOO
SSSSSSSSSSOSOOOOOO
SSSSSSSSSOOSOOOOOO
SSSSSSSSOOOSOOOOOO
SSSSSSSOOOOSOOOOOO
SSSSSSSOOOOSOOOOOO
SSSSSSWOOOOSOOOOOO
SSSSSSWOOOOSOOOOOO
SSSSSSWOOOSOOOOOOO
SSSSSSSOOOSOOOOOOO
SSSSSSSOOOSOOOOOOO
SSSSSSSOOOOOOOOOOO
SSSSSSSOOOOOOOOOOO
SSSSSSSOOOOOOOOOOO
SSSSSSSOOOOOOOOOOO
SSSSSSSOOOOOOOOOOO
SSSSSSSOOOOOOOOOOO
SSSSSSSOOOOOOOOOOO
SSSSSSSOOOOOOOOOOO
SSSSSSSOOOOOOOOOOO
SSSSSSSOOOOOOOOOOO
SSSSSSSOOOOOOOOOOO
SSSSSSSOOOOOOOOOOO
SSSSSSSOOOOOOOOOOO
SSSSSSSOOOOOOOOOOO
SSSSSSSOOOOOOOOOOO
SSSSSSSOOOOOOOOOOO
SSSSSSSOOOOOOOOOOO
SSSSSSOOOOOSSOOOOO
SSSSSSOOOOOSSOOOOO
SSSSSSOOOOOSWOOOOO
SSSSSSOOOOOSWOOOOO
SSSSSSOOOOOSSOOOOO
SSSSSSOOOOOSSOOOOO
SSSSSSOOOOSOOOOOOO
SSSSSSOOOOSOOOOOOO
SSSSSSOOOOSOOOOOOO
SSSSSSOOOOSOOOOOOO
SSSSSSOOOOSOOOOOOO
SSSSSSOOOOOOOOOOOO
SSSSSSOOOOOOOOOOOO
SSSSSSOOOOOOOOOOOO
SSSSSSOOOOOOOOOOOO
SSSSSSOOOOOOOOOOOO
SSSSSSOOOOOOOOOOOO
SSSSSSOOOOOOOOOOOO
SSSSSSSOOOOOOOOOOO
SSSSSSSOOOOOOOOOOO
SSSSSSSOOOOOOOOOOO
SSSSSSSOOOOOOOOOOO
SSSSSSSOOOOOOOOOOO
SSSSSSSOOOOOOOOOOO
SSSSSSSOOOOOOOOOOO
SSSSSSSOOOOOOOOOOO
SSSSSSSOOOOOOOOOOO
SSSSSSSOOSOOOOOOOO
SSSSSSSOOSOOOOOOOO
SSSSSSSOOSOOOOOOOO
SSSSSSSOOSOOOOOOOO
SSSSSSSOOSOOOOOOOO
SSSSSSSOOSOOOOOOOO
SSSSSSSOOOOOOOOOOO
SSSSSSSOOOOOOOOOOO
SSSSSSSOOOOOOOOOOO
SSSSSSSOOOOOOOOOOO
SSSSSSSOOOOOOOOOOO
SSSSSSSOOOOOOOOOOO
SSSSSSSOOOOOOOOOOO
SSSSSSSOOOOOOOOOOO
SSSSSSSOOOOOOOOOOO
SSSSSSSOOOOOOOOOOO
SSSSSSSOOOOOOOOOOO
SSSSSSSOOOOOOOOOOO
SSSSSSSOOOOOOOOOOO
SSSSSSSOOOOOOOOOOO
SSSSSSSOOOOOOOOOOO
SSSSSSSOOOOOOOOOOO
SSSSSSSOOOOOOOOOOO
