OOOOOOOOOOOSSSSSSS
OOOOOOOOOOOSSSSSSS
OOOOOOOOOOOSSSSSSS
OOOOOOOOOOOSSSSSSS
OOOOOOOOOOOSSSSSSS
OOOOOOOOOOOSSSSSSS
OOOOOOOOOOOSSSSSSS
OOOOOOOOOOOSSSSSSS
OOOOOOOOOOOSSSSSSS
OOOOOOOOOOOSSSSSSS
OOOOOOOOOOOSSSSSSS
OOOOOOOOOOOWSSSSSS
OOOOOOOOOOOWSSSSSS
OOOOOOOOOOOWSSSSSS
OOOOOOOOOOOWSSSSSS
OOOOOOOOOOOWSSSSSS
OOOOOOOOOOOWSSSSSS
OOOOOOOOOOOSSSSSSS
OOOOOOOOOOOSSSSSSS
OOOOOOOOOOOSSSSSSS
OOOOOOOOOOOSSSSSSS
OOOOOOSOOOOSSSSSSS
OOOOOOSOSSSSSSSSSS
OOOOOOSOOSSSSSSSSS
OOOOOOSOOOSSSSSSSS
OOOOOOSOOOOSSSSSSS
OOOOOOSOOOOSSSSSSS
OOOOOOSOOOOWSSSSSS
OOOOOOSOOOOWSSSSSS
OOOOOOOSOOOWSSSSSS
OOOOOOOSOOOSSSSSSS
OOOOOOOSOOOSSSSSSS
OOOOOOOOOOOSSSSSSS
OOOOOOOOOOOSSSSSSS
OOOOOOOOOOOSSSSSSS
OOOOOOOOOOOSSSSSSS
OOOOOOOOOOOSSSSSSS
OOOOOOOOOOOSSSSSSS
OOOOOOOOOOOSSSSSSS
OOOOOOOOOOOSSSSSSS
OOOOOOOOOOOSSSSSSS
OOOOOOOOOOOSSSSSSS
OOOOOOOOOOOSSSSSSS
OOOOOOOOOOOSSSSSSS
OOOOOOOOOOOSSSSSSS
OOOOOOOOOOOSSSSSSS
OOOOOOOOOOOSSSSSSS
OOOOOOOOOOOSSSSSSS
OOOOOOOOOOOSSSSSSS
OOOOOSSOOOOOSSSSSS
OOOOOSSOOOOOSSSSSS
OOOOOWSOOOOOSSSSSS
OOOOOWSOOOOOSSSSSS
OOOOOSSOOOOOSSSSSS
OOOOOSSOOOOOSSSSSS
OOOOOOOSOOOOSSSSSS
OOOOOOOSOOOOSSSSSS
OOOOOOOSOOOOSSSSSS
OOOOOOOSOOOOSSSSSS
OOOOOOOSOOOOSSSSSS
OOOOOOOOOOOOSSSSSS
OOOOOOOOOOOOSSSSSS
OOOOOOOOOOOOSSSSSS
OOOOOOOOOOOOSSSSSS
OOOOOOOOOOOOSSSSSS
OOOOOOOOOOOOSSSSSS
OOOOOOOOOOOOSSSSSS
OOOOOOOOOOOSSSSSSS
OOOOOOOOOOOSSSSSSS
OOOOOOOOOOOSSSSSSS
OOOOOOOOOOOSSSSSSS
OOOOOOOOOOOSSSSSSS
OOOOOOOOOOOSSSSSSS
OOOOOOOOOOOSSSSSSS
OOOOOOOOOOOSSSSSSS
OOOOOOOOOOOSSSSSSS
OOOOOOOOSOOSSSSSSS
OOOOOOOOSOOSSSSSSS
OOOOOOOOSOOSSSSSSS
OOOOOOOOSOOSSSSSSS
OOOOOOOOSOOSSSSSSS
OOOOOOOOSOOSSSSSSS
OOOOOOOOOOOSSSSSSS
OOOOOOOOOOOSSSSSSS
OOOOOOOOOOOSSSSSSS
OOOOOOOOOOOSSSSSSS
OOOOOOOOOOOSSSSSSS
OOOOOOOOOOOSSSSSSS
OOOOOOOOOOOSSSSSSS
OOOOOOOOOOOSSSSSSS
OOOOOOOOOOOSSSSSSS
OOOOOOOOOOOSSSSSSS
OOOOOOOOOOOSSSSSSS
OOOOOOOOOOOSSSSSSS
OOOOOOOOOOOSSSSSSS
OOOOOOOOOOOSSSSSSS
OOOOOOOOOOOSSSSSSS
OOOOOOOOOOOSSSSSSS
OOOOOOOOOOOSSSSSSS
