OOOOOOOOOOOOOOOOOOOOOOOOOOOOOOOOOOOOOOOOOOOOOOOOOOOOOOOOOOOOOOOOOOOOOOOOOOOOOOOOOOOOOOOOOOOOOOOOOOOO
OOOOOOOOOOOOOOOOOOOOOOOOOOOOOOOOOOOOOOOOOOOOOOOOOOOOOOOOOOOOOOOOOOOOOOOOOOOOOOOOOOOOOOOOOOOOOOOOOOOO
OOOOOOOOOOOOOOOOOOOOOOOOOOOOOOOOOOOOOOOOOOOOOOOOOOOOOOOOOOOOOOOOOOOOOOOOOOOOOOOOOOOOOOOOOOOOOOOOOOOO
OOOOOOOOOOOOOOOOOOOOOOOOOOOOOOOOOOOOOOOOOOOOOOOOOOOOOOOOOOOOOOOOOOOOOOOOOOOOOOOOOOOOOOOOOOOOOOOOOOOO
OOOOOOOOOOOOOOOOOOOOOOOOOOOOOOOOOOOOOOOOOOOOOOOOOOOOOOOOOOOOOOOOOOHOOOOOOOOOOOOOOOOOOOOOOOOOOOOOOOOO
OOOOOOOOOOOOOOOOOOOOOOOOOOOOOOOOOOOOOOOOOOOOOOOOOSSWWSSOOOOOOOOOOOTZZZOOOOOOOOOOOOOOOOOOOOOOOOOOOOOO
OHOOOOOOOOOOOOOOOOOOOSSSSSSSSOOOOOOOOOOOOOOOOOOOOSSSSSSOOOOOOOOOOOTZZZOOOOOOOOOOOOOOOOOOOOOOOOOOOOOO
OTZZZOOOOOOOOOOOOOOOOZZZZZZZZSSSOOOOOOOOOOOOOOOOOZZZZZZSSSSSOOOOOOTZZZOOOOOOOOOOOOOOOOOOOOOOOOOXXXXX
OTZZZOOOOOOOOOOOOOOOOZSZZZZZZZZZOOOOOOOOOOOOOOOOOZZZZZZZZZZZOOOOOOTZZZOOOOOOSSSSSSOOOOOOOOOOOOOXXXXX
OZZZZOOOOOOOOOOOOOOOOZSSZZZZZZZZOOOOOOOOOOOOOOOOOZZZZZZZZZZZOOOOOOZZZZOOOOOOZZZZZZOOOOOOOOOOOOOXXXXX
OBZZZOOOOOOOOOOOOOOOOZSSSZZZZZZZOOOOOOOOOOOOOOOOOZZZZZZZZZZZOOOOOOBZZZOOOOOOZZZZZZOOOOOOOOOOOOOXXXXX
SSSSSSSSSSSWWWWWWSSSSSSSSSSWWWSSSSSSSSSSSSSSSSSSSOOOOOOOOOOOOOOOOOOSSSSSSSSSSSSSSSSSSSSSSSSSSSSSSSSS
SSSSSSSSSSSSSSSSSSSSSSSSSSSSSSSSSSSSSSSSSSSSSSSSSSSSSSSSSSSSSSSSSSSSSSSSSSSSSSSSSSSSSSSSSSSSSSSSSSSS
SSSSSSSSSSSSSSSSSSSSSSSSSSSSSSSSSSSSSSSSSSSSSSSSSSSSSSSSSSSSSSSSSSSSSSSSSSSSSSSSSSSSSSSSSSSSSSSSSSSS
SSSSSSSSSSSSSSSSSSSSSSSSSSSSSSSSSSSSSSSSSSSSSSSSSSSSSSSSSSSSSSSSSSSSSSSSSSSSSSSSSSSSSSSSSSSSSSSSSSSS
SSSSSSSSSSSSSSSSSSSSSSSSSSSSSSSSSSSSSSSSSSSSSSSSSSSSSSSSSSSSSSSSSSSSSSSSSSSSSSSSSSSSSSSSSSSSSSSSSSSS
SSSSSSSSSSSSSSSSSSSSSSSSSSSSSSSSSSSSSSSSSSSSSSSSSSSSSSSSSSSSSSSSSSSSSSSSSSSSSSSSSSSSSSSSSSSSSSSSSSSS
SSSSSSSSSSSSSSSSSSSSSSSSSSSSSSSSSSSSSSSSSSSSSSSSSSSSSSSSSSSSSSSSSSSSSSSSSSSSSSSSSSSSSSSSSSSSSSSSSSSS