OOOOOOOOOOOOOOOOOOOOOOOOOOOOOOOOOOOOOOOOOOOOOOOOOOOOOOOOOOOOOOOOOOOOOOOOOOOOOOOOOOOOOOOOOOOOOOOOOOO
OOOOOOOOOOOOOOOOOOOOOOOOOOOOOOOOOOOOOOOOOOOOOOOOOOOOOOOOOOOOOOOOOOOOOOOOOOOOOOOOOOOOOOOOOOOOOOOOOOO
OOOOOOOOOOOOOOOOOOOOOOOOOOOOOOOOOOOOOOOOOOOOOOOOOOOOOOOOOOOOOOOOOOOOOOOOOOOOOOOOOOOOOOOOOOOOOOOOOOO
OOOOOOOOOOOOOOOOOOOOOOOOOOOOOOOOOOOOOOOOOOOOOOOOOOOOOOOOOOOOOOOOOOOOOOOOOOOOOOOOOOOOOOOOOOOOOOOOOOO
OOOOOOOOOOOOOOOOOOOOOOOOOOOOOOOOOOOOOOOOOOOOOOOOOOOOOOOOOOOOOOOOOOHZZZOOOOOOOOOOOOOOOOOOOOOOOOOOOOO
OOOOOOOOOOOOOOOOOOOOOOOOOOOOOOOOOOOOOOOOOOOOOOOOOSSWWSSOOOOOOOOOOOTZZZOOOOOOOOOOOOOOOOOOOOOOOOOOOOO
OHZZZOOOOOOOOOOOOOOOOSSSSSSSSOOOOOOOOOOOOOOOOOOOOSSSSSSOOOOOOOOOOOTZZZOOOOOOOOOOOOOOOOOOOOOOOOOOOOO
OTZZZOOOOOOOOOOOOOOOOZZZZZZZZSSSOOOOOOOOOOOOOOOOOZZZZZZSSSSSOOOOOOTZZZOOOOOOOOOOOOOOOOOOOOOOOOOXXXX
OTZZZOOOOOOOOOOOOOOOOZSZZZZZZZZZOOOOOOOOOOOOOOOOOZZZZZZZZZZZOOOOOOTZZZOOOOOOSSSSSSOOOOOOOOOOOOOXXXX
OOZZZOOOOOOOOOOOOOOOOZSSZZZZZZZZOOOOOOOOOOOOOOOOOZZZZZZZZZZZOOOOOOOZZZOOOOOOZZZZZZOOOOOOOOOOOOOXXXX
OBZZZOOOOOOOOOOOOOOOOZSSSZZZZZZZOOOOOOOOOOOOOOOOOZZZZZZZZZZZOOOOOOBZZZOOOOOOZZZZZZOOOOOOOOOOOOOXXXX
SSSSSSSSSSSWWWWWWSSSSSSSSSSWWWSSSSSSSSSSSSSSSSSSSOOOOOOOOOOOOOOOOOOSSSSSSSSSSSSSSSSSSSSSSSSSSSSSSSS
SSSSSSSSSSSSSSSSSSSSSSSSSSSSSSSSSSSSSSSSSSSSSSSSSSSSSSSSSSSSSSSSSSSSSSSSSSSSSSSSSSSSSSSSSSSSSSSSSSS
SSSSSSSSSSSSSSSSSSSSSSSSSSSSSSSSSSSSSSSSSSSSSSSSSSSSSSSSSSSSSSSSSSSSSSSSSSSSSSSSSSSSSSSSSSSSSSSSSSS
SSSSSSSSSSSSSSSSSSSSSSSSSSSSSSSSSSSSSSSSSSSSSSSSSSSSSSSSSSSSSSSSSSSSSSSSSSSSSSSSSSSSSSSSSSSSSSSSSSS
SSSSSSSSSSSSSSSSSSSSSSSSSSSSSSSSSSSSSSSSSSSSSSSSSSSSSSSSSSSSSSSSSSSSSSSSSSSSSSSSSSSSSSSSSSSSSSSSSSS
SSSSSSSSSSSSSSSSSSSSSSSSSSSSSSSSSSSSSSSSSSSSSSSSSSSSSSSSSSSSSSSSSSSSSSSSSSSSSSSSSSSSSSSSSSSSSSSSSSS
SSSSSSSSSSSSSSSSSSSSSSSSSSSSSSSSSSSSSSSSSSSSSSSSSSSSSSSSSSSSSSSSSSSSSSSSSSSSSSSSSSSSSSSSSSSSSSSSSSS