VVVVVVVVVVVVVVVVVVVVVVPPPPPPPPPPPPPPPPPPPPPPVVVVVVVVVVVVVVVVVVVVVV
VVVVVVVVVVVVVVOOOOOOOVOOOOOOOOOOOOOOOOOOOOOOVOOOOOOOVVVVVVVVVVVVVV
VVVVVVVVVVVVVVOOOOOOOVOOOOOOOOOOOOOOOOOOOOOOVOOOOOOOVVVVVVVVVVVVVV
VVVVVVVVVVVVVVOOOOOOOVOOOOOOOOOOOOOOOOOOOOOOVOOOOOOOVVVVVVVVVVVVVV
VVVVVVVVVVVVVVZZZZZZZVOOOOOOOOOOOOOOOOOOOOOOVZZZZZZZVVVVVVVVVVVVVV
VVVVVVVVVVVVVVZZZZZZZVOOOOOOOOOOXXOOOOOOOOOOVZZZZZZZVVVVVVVVVVVVVV
VVVVVVVVVVVVVVZZZZZZZVOOOOOOOOOOXXOOOOOOOOOOVZZZZZZZVVVVVVVVVVVVVV
VVVVVVVVVVVVVVZZZZZZZVOOOOOOOOVVVVVVOOOOOOOOVZZZZZZZVVVVVVVVVVVVVV
VVVVVVVVVVVVVVZZZZZVVVOOOOOOOOOOOOOOOOOOOOOOVVVZZZZZVVVVVVVVVVVVVV
VVVVVVVVVVVVVVZZZZZZZZOOOOOOOOOOOOOOOOOOOOOOZZZZZZZZVVVVVVVVVVVVVV
VVVVVVVVVVVVVVZZZZZZZZOOOOOOOOOOOOOOOOOOOOOOZZZZZZZZVVVVVVVVVVVVVV
VVVVVVVVVVVVVVZZZZZZZZOOOOOOOOOOOOOOOOOOOOOOZZZZZZZZVVVVVVVVVVVVVV
VVVVVVVVVVVVVVVVVVVVVVVVVVVVVWWWWWWWWVVVVVVVVVVVVVVVVVVVVVVVVVVVVV
VVVVVVVVVVVVVVVVVVVVVVVVVVVVVVVVVVVVVVVVVVVVVVVVVVVVVVVVVVVVVVVVVV
VVVVVVVVVVVVVVVVVVVVVVVVVVVVVVVVVVVVVVVVVVVVVVVVVVVVVVVVVVVVVVVVVV
VVVVVVVVVVVVVVVVVVVVVVVVVVVVVVVVVVVVVVVVVVVVVVVVVVVVVVVVVVVVVVVVVV
VVVVVVVVVVVVVVVVVVVVVVVVVVVVVVVVVVVVVVVVVVVVVVVVVVVVVVVVVVVVVVVVVV
VVVVVVVVVVVVVVVVVVVVVVVVVVVVVVVVVVVVVVVVVVVVVVVVVVVVVVVVVVVVVVVVVV
VVVVVVVVVVVVVVVVVVVVVVVVVVVVVVVVVVVVVVVVVVVVVVVVVVVVVVVVVVVVVVVVVV
VVVVVVVVVVVVVVVVVVVVVVVVVVVVVVVVVVVVVVVVVVVVVVVVVVVVVVVVVVVVVVVVVV