VVVVVVVVVOOOOOOOOOOOOOOOOOOOOOOVVVVVVVVV
VOOOOOOOVOOOOOOOOOOOOOOOOOOOOOOVOOOOOOOV
VOOOOOOOVOOOOOOOOOOOOOOOOOOOOOOVOOOOOOOV
VOOOOOOOVOOOOOOOOOOOOOOOOOOOOOOVOOOOOOOV
VZZZZZZZVOOOOOOOOOOOOOOOOOOOOOOVZZZZZZZV
VZZZZZZZVOOOOOOOOOOOOOOOOOOOOOOVZZZZZZZV
VZZZZZZZVOOOOOOOOOOOOOOOOOOOOOOVZZZZZZZV
VZZZZZZZVOOOOOOOOOOOOOOOOOOOOOOVZZZZZZZV
VZZZZZVVVOOOOOOOOOOOOOOOOOOOOOOVVVZZZZZV
VZZZZZZZZOOOOOOOOOOOOOOOOOOOOOOZZZZZZZZV
VZZZZZZZZOOOOOOOOOOOOOOOOOOOOOOZZZZZZZZV
VZZZZZZZZOOOOOOOOOOOOOOOOOOOOOOZZZZZZZZV
VVVVVVVVVVVVVVVVVVVVVVVVVVVVVVVVVVVVVVVV
VVVVVVVVVVVVVVVVVVVVVVVVVVVVVVVVVVVVVVVV
VVVVVVVVVVVVVVVVVVVVVVVVVVVVVVVVVVVVVVVV
VVVVVVVVVVVVVVVVVVVVVVVVVVVVVVVVVVVVVVVV
VVVVVVVVVVVVVVVVVVVVVVVVVVVVVVVVVVVVVVVV
VVVVVVVVVVVVVVVVVVVVVVVVVVVVVVVVVVVVVVVV